11111111111111111111
10000000000000000001
10111111110111111101
10100000010100000001
10101111110101111101
10101000010101000001
10101011110101111101
10101010000101000001
10101010111101011101
10101010100001010101
10101010101111010101
10101010101001010101
10101010101001110101
10101000001000000001
10101111111111111001
10000000000000000001
11111111111111111111
